12 14
##############
#........a...#
#............#
#...a.....A..#
#..####...A..#
#..aa.....@A.#
#..aa.#......#
#.....##....a#
#.......AA...#
#........A...#
#............#
##############
